NO ./textures_l/Brick/Brick_01-512x512.png
SO ./textures_l/Brick/Brick_01-512x512.png
WE ./textures_l/Brick/Brick_01-512x512.png
EA ./textures_l/Brick/Brick_01-512x512.png

F 225,30,60
C 12,10,250

11111111111111111111111111
1N000000000110000000000001
10110000011100000000000001
1001000000000000000000001
11111111101100000111000011111
10000000001100000111000000001
11110111111111011100000010001
11110111111111011101010010001
11000000110101011100000010001
11111000000000001100000010001
11  1000000000001101010010001
1111100111010101111101111000111
11110111 1110101 101111010001
11111111 1111111 111111111111
