

NO ./textures_l/Brick/Brick_15-512x512.png
SO ./textures_l/Stone/Stone_14-512x512.png
WE ./textures_l/Wood/Wood_16-512x512.png
EA ./textures_l/Stone/Stone_14-512x512.png


F 112,128,144
C 25,25,112



111111111111111111111111111
1000000000000000000000000001
1E0000000001100000000000011
101100000111000000000000011
1001000000000000000000100001
11111111101100000111000011111
10000000001100000111000000001
11110111111111011100000010001
11110111111111011101010010001
11000000110101011100000010001
11111000000000001100000010001
11  1000000000001101010010001
1111100111010101111101111000111
11110111 1110101 101111010001
11111111 1111111 111111111111
